R         -550       -550

C   123 , 30 , 145

    NO         ./path_to_the_north_texture

SO    ./path_south_texture


                                WE    ./path_to_the_west_texture



            EA        ./path_to_the_east_texture













    F    225,  225,     20


S             ./path_to_the_sprite_texture


        1111111111111111111111111   111
        1000000000110000000000001   1011
        1011000001110000000001001   101
        1001000000000000000000001   101
111111111011000001110000000000001   1111
100000000011000001110111111111111
11110111111111011100000010001
11110111111111011101010010001
11000000110101011100000012001
10002000000000001100000012001
10000000000000001101010002221
110000011101010111110111122111
11110111 1110101 101111012221
11111111 1111111 111111111111
11110111111111011101010010N01
11000000110101011100000012001
10002000000000001100000012201
10000000000000001101010002221
110000011101010111110111122111
11110111 1110101 101111012221
11111111 1111111 111111111111